############
# O        #
# P      ###
#          #
#######     
# O  ##    #
#     #    #
#          #
#   XX     #
#     #    #
############
