   ####
 ##  O #
#  XXO #
#P  #OO#
 #  ##  #
 # X X  #
 #  #  #
  #####
